    6145, 6149, 6151, 6153, 8715, 6155, 6157, 8717, 8719, 8721,
    6161, 6163, 8725, 4117, 4119, 8726, 6165, 6167, 4121, 8727,
    8733, 6174, 4127, 3616, 4129, 3105, 3101, 4125, 3623, 3115,
    3117, 3629, 3119, 8751, 3121, 8753, 3123, 1581, 3125, 4151,
    6201, 6213, 6237, 5213, 6239, 4709, 4713, 4714, 6261, 4733,
    5245, 5247, 4735, 4745, 3721, 3723, 4749, 4751, 6803, 3731,
    4755, 6805, 6299, 2717, 7329, 7331, 7337, 7339, 7343, 2737,
    6837, 5301, 5303, 2743, 2745, 2747, 5307, 6143, 6847, 5331,
    8915, 5337, 5339, 5341, 5343, 8929, 5349, 3815, 3817, 3821,
    8951, 3833, 8957, 3837, 2815, 2817, 8701, 2819, 2823, 4123,
    3849, 2825, 3853, 3855, 3857, 3861, 3863, 6429, 4903, 9001,
    4435, 9003, 4401, 4409, 3901, 4927, 3903, 9027, 4933, 4938,
    3403, 4429, 4431, 3919, 4943, 4944, 3923, 4946, 3925, 4433,
    3415, 4439, 2905, 4441, 3419, 4437, 2903, 3423, 3425, 2915,
    3427, 2917, 3429, 2919, 3433, 7017, 3435, 7531, 3439, 2927,
    7025, 3441, 3443, 2931, 2933, 3445, 3447, 7027, 2937, 3449,
    2935, 5503, 5509, 5001, 5515, 5005, 5519, 5007, 5009, 5522,
    8731, 5530, 4509, 5537, 5539, 5543, 5033, 5041, 4529, 4531,
    7603, 4535, 4537, 5049, 4541, 8133, 8135, 3015, 4553, 3017,
    3019, 4551, 7629, 7631, 2001, 7633, 7635, 6101, 6113, 2023,
    3051, 1521, 6131, 6645, 6135, 6137, 6139, 6141, 8703